*****XX****X********XXXXX
XX******XX***XXXXX***XXXX
XX***XXXX**XXXXX****XXXXX
XX***XXXXXXXXXXXXXX****XX
*****XXXXXX****XX***XXXXX
XX*************XXXX******